222222222222222222222222222222222222222222
222111211221112111211121112111211111111122
222101210121012101210121012101210000000122
222101110121012101210121012101210111111122
222100000121012101210121012101210122222222
222111110111011101210121012101110111112222
222222210000000001210121012100000000012222
211111110111111101210111011100011101112222
210000000122222101210000000000012101222222
211111111121111101110000000001112111222222
222222222221000000000000000001222222222222
222222211111011111111100000001112222222222
222222210000012222222100000000012222222222
222221110111011121111101110000011111111122
222221000121000121000001210000000000000122
222221111121110121011101211101111101110122
222222222222210121012101222101222101210122
222222222221110121012101211101112101211122
222222222221000121012101210000012101222222
222222222221111121112111211111112111222222
222222222222222222222222222222222222222222
222222222222222222222222222222222222222222
